0;0;0;0;0;0;0;0;0;0
0;L;C;L;L;C;L;L;C;L
0;0;N;0;0;S;0;0;N;0
0;0;N;0;0;S;0;0;N;0
0;R;N;R;R;S;R;R;C;R
0;0;N;0;0;S;0;0;N;0
0;0;N;0;0;S;0;0;N;0
0;L;C;L;L;C;L;L;C;L
0;0;N;0;0;S;0;0;N;0
0;0;N;0;0;S;0;0;N;0
0;R;C;R;R;C;R;R;C;R
0;L;C;L;L;C;L;L;C;L
0;0;N;0;0;S;0;0;N;0
0;0;N;0;0;S;0;0;N;0
0;L;C;L;L;C;L;L;C;L
0;0;N;0;0;S;0;0;N;0
0;0;N;0;0;S;0;0;N;0
0;R;N;R;R;C;R;R;C;R
0;0;N;0;0;S;0;0;N;0