0;0;R;0;0;0;0;0;0;0
0;L;C;L;L;C;L;L;C;L
0;0;N;0;0;S;0;0;N;0
0;0;N;0;0;S;0;0;N;0
0;R;N;R;R;S;R;R;C;R
0;0;N;S;0;S;0;0;N;0
0;0;N;0;0;S;0;0;N;0
0;L;ND;L;L;C;L;L;C;L
0;0;N;0;R;S;0;0;N;0
0;0;N;0;L;S;0;0;N;0
0;C;N;R;R;C;R;R;C;R
0;L;N;L;L;C;L;L;C;L
0;0;N;0;0;S;0;0;N;0
0;0;N;0;0;S;0;0;N;0
0;L;C;L;L;C;L;L;C;L
0;0;N;0;0;S;0;0;N;0
0;0;N;0;0;S;0;0;N;0
0;R;N;R;R;C;R;R;C;R
0;0;N;0;0;S;0;0;N;0